#####################
#                   #
#                   #
#                   #
#         #         #
#         #         #
#         #         #
#         #         #
#         #         #
###########         #
#                   #
#         ###########
#         #         #
#         #         #
#         #         #
#         #         #
#         #         #
#                   #
#                   #
#                   #
#####################
