#####################
#                   #
#                   #
#  ################ #
#                   #
#                   #
#  ################ #
#                   #
#                   #
#  ################ #
#                   #
#                   #
#  ################ #
#                   #
#                   #
#  ################ #
#                   #
#                   #
#                   #
#                   #
#####################
