211111111111111111112
110000000000000000011
101000000000000000101
100100000000000001001
100010000000000010001
100001000000000100001
100000100000001000001
100000010000010000001
100000001000100000001
100000000101000000001
100000000010000000001
100000000101000000001
100000001000100000001
100000010000010000001
100000100000001000001
100001000000000100001
100010000000000010001
100100000000000001001
101000000000000000101
110000000000000000011
211111111111111111112
