#####################
#     #             #
# ### # ########### #
# #   #         #   #
# # ######### # # # #
# # #       # # # # #
# # # ##### # # # # #
# # # #   # # # # # #
# # # # # # # # # # #
#   # # # # #   #   #
##### # # ######### #
#     # #           #
# ##### ########### #
#       #           #
# ################# #
#                   #
# ###############   #
#             #     #
# ############# #####
#####################

