211111111111111111112
101000000000000000001
101000000000000000001
101000000001111000001
100000000000000000001
100011000000000000001
100000000000000000001
100110000000000110001
100000000100000000001
100000011111100000001
100000000000000000001
100000111000000000001
100000000000000000001
100000000000000000001
100000011000000000001
100000000000000000001
100000000000000000001
100110000000000000001
100000000000011110001
100000000000000000001
211111111111111111112
