211111111111111111112
100000000000000000001
100110000000000000001
100010000000000011001
100011000000000110001
100000000000000000001
100000000100000000001
100000001110000000001
100000011110000000001
100110000000000100001
100000000000110000001
100000000000011100001
100000000000000000001
100000101000000000001
100000101000000000001
100001111110000000001
100000000000000000001
100000000000000000001
100000000000001110001
100000000000011000001
211111111111111111112
